G......................G
...B...BBB...BBB...BBB..
...B..B---B.B---B.B...B.
.BBB..B---B.B---B.....B.
...B..B---B.B---B...BB..
...B...BBBB..BBBB.....B.
B..B......B.....B.B...B.
...B......B.....B..BBB..
........................
.BBBB.BBB.B..B.BBB.BBB..
....B.B-B.B..B.B...B--B.
...B..B-B.BB.B.B...B--B.
..B...B-B.B.BB.BB..BBB..
.B....B-B.B..B.B...B.B..
.BBBB.BBB.B..B.BBB.B..B.
............P...........