G......................G
..BBBB..BBB....B.BBBB...
.....B.B---B...B....B...
B....B.B---B.BBB....B...
..BBBB.B---B...B...BBB..
..B....B---B...B....B...
..B....B---B...B....B...
..BBBB..BBB....B....B..B
........................
.B...B..BBB.B..B..B...B.
.BB.BB..B...B..B...B.B..
.B.B.B..B...BB.B....B...
.B...B..BB..B.BB....B...
.B...B..B...B..B....B..B
.B...B..BBB.B..B....B...
G...........P..........G