G............BB.BB.B.BGB
.BB.BB.B.B.B.......B.B.B
.......B.B.B.B.B.B......
.B.B.B.......B.B.B.BB.BB
.B.B.B.BB.B.............
P...........BB.BB.B.B.B.
BB.BB.B.B.B.......B.B.B.
......B.B.B.B.B.B.......
B.B.B.......B.B.B.BB.BB.
B.B.B.BB.BB.............
.............BB.BB.B.B.B
.BB.BB.B.B.B.......B.B.B
.......B.B.B.B.B.B......
.B.B.B.......B.B.B.BB.BB
.B.B.B.BB.B.............
G...........BB.BB.B.B.BG