G..........B...........G
.BBBBBBBBB.B.BBBBBBBBBB.
.B......................
.B.BBBBBBBBB.BBBBBBBBBB.
.B.B...........B......B.
.B.B.B..B......B..B.B.B.
.....B....BB.B....B.B...
BB.B.B....B..B..BBB.B.BB
...B.BBB..B..B....B.....
.B.B.B....B.BB....B.B.B.
.B.B.B..B......B..B.B.B.
.B......B...........B.B.
.BBBBBBBBBB.BBBBBBBBB.B.
......................B.
.BBBBBBBBBB.B.BBBBBBBBB.
G...........BP.........G