G.BBB...B......B...BBB.G
...B..B...B..B...B..B...
.B...BB..BB..BB..BB...B.
.BB...B..........B...BB.
.B..B....B.B..B....B..B.
....BB..BB..B.BB..BB....
BBB.B..............B.BBB
B.....BB...BB...BB.....B
B......BB..BB..BB......B
BBB.B..............B.BBB
....BB..BB..B.BB..BB....
.B..B....B.B..B....B..B.
.BB...B..........B...BB.
.B...BB..BB..BB..BB...B.
...B..B...B..B...B..B...
G.BBB...B....P.B...BBB.G