G..B................B..G
.B.B.BBBBB.B.BBBBBB.B.B.
...........B............
BB.BBB.BB..B..BBB.BBB.BB
...B.......B........B...
...B.BBBBB.B.BBBBBB.B.B.
...B.......B........B...
.BBBBBBBBBB..BBBBBBBBBB.
...B........B.......B...
.B.B.BBBBBB.B.BBBBB.B.B.
.B.B........B.......B.B.
...B...BB...B..BB...B...
BB.BBB.BB...B..BB.BBB.BB
............B...........
.B.B.BBBBBB.B.BBBB..B.B.
G..B........P.......B..G