G.............B........G
.B.BBBBBB.BB.BB.BBBBBBB.
.B......................
.B.BBB.BBBBB.BBBBB.BBBB.
.B.B.........B........B.
.B.B.BBB.BBB.B.BB.BBB.B.
.B.B................B.B.
...B.BB.BBBBBBBB.BB.B...
BB.B.B.BBBBBBBBBB.B.B.BB
...B................B...
.B.B.BB.BB.B.BBB.BB.B.B.
.B.........B........B.B.
.BBBBB.BBBBB.BBBBB.BB.B.
......................B.
.BBBBBBBB.BB.BB.BBBBB.B.
G.........BP...........G