G.....B...........B....G
.BBBB.B.BBB.B.BBB.B.BBB.
............B...........
.B.BBBBBB.B.B.B.BBBBB.B.
.B.BBBBBB.B.B.B.BBBBB.B.
......B.....B.....B.....
.BBBB.B.BBB.B.BBB.B.BBB.
........................
.BBBBBBBBBBBBBBBBBBBBBB.
........................
.BBBB.B.BBB.B.BBB.B.BBB.
......B.....B.....B.....
.B.BBBBBB.B.B.B.BBBBB.B.
............B...........
.BBBB.B.BBB.B.BBB.B.BBB.
G.....B.....P.....B....G